5 0 2
0 1 0 0 1 
0 0 2 1 0 
0 0 0 1 4 
0 1 4 0 0 
0 3 0 3 0 
